NO ./textures/Textura_madera.xpm
SO ./textures/Textura_mosaico.xpm
WE ./textures/Textura_piedra.xpm
EA ./textures/Textura_lava.xpm

F 74, 120, 190
C 43, 110, 150



        11111111111111111111111111
        1000000000110000000000001111
        1011000001110000000000001
        100101000000000000000001
1111111110111 1001110000000000001111
10000000001101000111011111111111111
1111011111111101110000001000111
11110111111111011101010010001101
11000000110101011100000010001111
1000000000010001100000010001111111111
1000W0111000001101010010001
1101001110111011111011110001111
11110111 1110101 101111010001
11111111 1111111 111111111111





