NO ./textures/Textura_madera.xpm
SO ./textures/Textura_mosaico.xpm
WE ./textures/Textura_piedra.xpm
EA ./textures/Textura_lava.xpm

F 140, 65, 30
C 0, 255, 0

1111111111111111111        111111111111111111
1000000000000000001        100000000000000001
1000010000000000001        100000000000000001
100000000000000000111111111100000000000000001
10000000N000000000000000000000000000000000001
100000000000000000000000000000000000000000001
100000000000000000000000000000000000000000001
100000000000000000000000000000000000000000001
100000000000001000111111111111000000000000001
1000000000000010001          1000000111100001
1000000000000010001          1000000111100001
1000000000000010001          1000000111100001
1000000000000000001          1000000000000001
1111111111111111111          1111111111111111